111111111111111
1S0010001000101
111010101010101
100010001000101
101110111011101
100010001000001
111010101011111
100010001000001
101110111011101
100010001000101
111010101010101
100010001000101
101110111011101
1000000010000M1
111111111111111
