111111111111111
1S0000000000001
101111111111101
101000000000101
101011111110101
101010000010101
101010111010101
101010100010101
101010111010101
101010000010101
101011111110101
101000000000101
101111111111101
1000000000000M1
111111111111111
