111111111111111
1S0001000100001
101111011101101
100000010000101
111101110111101
100001000100001
101111011101111
100000010000001
111101110111101
100001000100001
101111011101101
100000010000101
111101110111101
1000010000000M1
111111111111111
