111111111111111
1S0000000000001
111111110111101
100000010100001
101111110111101
101000000000101
101011111111101
101010000000101
101010111111101
101010100000101
101010101111101
101010101000001
101010101011101
1000100000000M1
111111111111111
