111111111111111
1S1010101010101
101010101010101
101010101010101
101010101010101
101010101010101
101010101010101
101010101010101
101010101010101
101010101010101
101010101010101
101010101010101
101010101010101
1010101010101M1
111111111111111
