111111111111111
1S1111111111111
100000000000001
111111111111101
100000000000001
101111111111111
100000000000001
111111111111101
100000000000001
101111111111111
100000000000001
111111111111101
100000000000001
1M1111111111111
111111111111111
