111111111111111
1S1000100010001
101010101010101
100010001000101
111010101011101
100010001000001
101110111011111
100010001000001
111010111011101
100010001000101
101110101010101
100010001000101
111010111011101
1000000010000M1
111111111111111
